file = Файл
function = Функция
exception = <b>Исключение</b>: {0} в файле {1} в строке {2}
an_exception_occurred = Произошло исключение
trace = Error Trace
error = Ошибка
any = Любой
running = Запущен
not_running = Остановлен
none = Нет
first_name = Имя
last_name = Фамилия
email = Email
password = Пароль
country = Страна
phone = Телефон
ok = OK
nok = Не OK
username = Имя пользователя
warning = Предупреждение
new = Новый
disabled = Отключено
file_to_large = Выбранный файл слишком велик, допустимый размер - {0}
invalid_file_type =  Неверный тип выбранного файла
refresh = Обновить
select_one = -- Выбрать --
used_number = Номер <b>{0}</b> используется модулем {1}.
extension = Номер
unlimited = Неограниченно
system = Ситема
install = Установить
duplicated_description = Указанное описание уже используется.
duplicated_extension = Указанный номер уже используется.
edit = Изменить
download = Скачать
inherited = Унаследовано
duplicated_number = Указанный номер уже используется.
default = По умолчанию
description = Описание
accept = Принять
confirm = Подтвердить
restriction_msg = Вам не разрешено получать, редактировать или удалять запрашиваемую информацию
company = Компания
license = Лицензия
language = Язык
default_ringtime = По умолчанию ({0})
all = Все
report = Отчет
from_date = Дата начала
to_date = Дата окончания
actions = Действия
download_csv_format = Скачать в формате CSV
no_file_selected = Вы не выбрали ни одного файла
empty_file = Вы выбрали пустой файл
csv.invalid_file = Вы не выбрали CSV файл
select_country = -- Select Country --
select_state = -- Select State --
continue = Continue
tenant = Tenant
