an_exception_occurred = Une exception s'est produite
any = Tout
country = Pays
email = E-mail
error = Erreur
exception = <b>Exception</b>: {0} au fichier {1} à la ligne {2}
file = Fichier
first_name = Prénom
function = Fonction
last_name = Nom
nok = NOK
none = Aucun
not_running = Arrêté
ok = OK
password = Mot de passe
phone = Téléphone
running = En cours
trace = Trace d'erreur
username = nom d'utilisateur
warning = Avertissement
app_installing = {0} Installation
disabled = Désactivé
extension = Extension
file_to_large = Le fichier sélectionné est trop volumineux, la taille autorisée est {0}
invalid_file_type = Le type de fichier sélectionné n'est pas valide
new = Nouveau
refresh = Rafraîchir
select_one = -- Sélectionnez --
used_number = Le numéro <b>{0}</b> est utilisé par le module {1}.
accept = Accepter
company = Entreprise
confirm = Confirmer
default = Défaut
description = Description
download = Télécharger
duplicated_description = La description fournie est déjà utilisée.
duplicated_extension = L'extension fournie est déjà utilisée.
duplicated_number = Le numéro fourni est déjà utilisé.
edit = Modifier
inherited = Hérité
install = Installer
license = Licence
restriction_msg = Vous n'êtes pas autorisé à obtenir, modifier ou supprimer les informations demandées
system = Système
unlimited = Illimité
actions = Actions
all = Tout
csv.invalid_file = Vous n'avez pas sélectionné de fichier CSV
default_ringtime = Par défaut ({0})
download_csv_format = Télécharger le format CSV
empty_file = Vous avez sélectionné un fichier vide
from_date = Date de début
language = Langue
no_file_selected = Vous n'avez sélectionné aucun fichier
report = Rapport
to_date = Date de fin
select_country = -- Sélectionnez le pays --
select_state = -- Sélectionnez l'état --
continue = Continuer
tenant = Locataire
