file = Datei
function = Funktion
exception = <b>Ausnahme</b>: {0} in Datei {1} in Zeile {2}
an_exception_occurred = Eine Ausnahme ist aufgetreten
trace = Fehlerverfolgung
error = Fehler
any = Irgendein
running = Läuft
not_running = Gestoppt
none = Keiner
first_name = Vorname
last_name = Nachname
email = Email
password = Passwort
country = Land
phone = Telefon
ok = OK
nok = NOK
username = Nutzername
warning = Warnung
new = Neu
disabled = Deaktiviert
file_to_large = Die ausgewählte Datei ist zu groß, die zulässige Größe ist {0}
invalid_file_type = Der ausgewählte Dateityp ist ungültig
refresh = Aktualisierung
select_one = -- Wähle eins --
used_number = Die Nummer <b>{0}</b> wird vom Modul {1} verwendet.
extension = Nebenstelle
unlimited = Unbegrenzt
system = System
install = Installieren
duplicated_description = Die angegebene Beschreibung wird bereits verwendet.
duplicated_extension = Die angegebene Nebenstelle wird bereits verwendet.
edit = Bearbeiten
download = Herunterladen
inherited = Vererbt
duplicated_number = Die angegebene Nummer wird bereits verwendet.
default = Standard
description = Beschreibung
accept = Annehmen
confirm = Bestätigung
restriction_msg = Sie dürfen die angeforderten Informationen nicht abrufen, bearbeiten oder löschen
company = Firma
license = Lizenz
language = Sprache
default_ringtime = Standard ({0})
all = Alle
report = Bericht
from_date = Startdatum
to_date = Enddatum
actions = Aktionen
download_csv_format = CSV-Format herunterladen
no_file_selected = Sie haben keine Datei ausgewählt
empty_file = Sie haben eine leere Datei ausgewählt
csv.invalid_file = Sie haben keine CSV-Datei ausgewählt
select_country = -- Land auswählen --
select_state = -- Staat wählen --
continue = Weiter
tenant = Mandant
